day in day out - codziennie, swiatek piatek
throughput (frouput) - wydajnosc
the park is littered with trash - park jest zasmiecony
resourceful - good at solving problems
the weather is currently in a state of flux - is changing constantly
... for nearly a decade, time flies! - czas szybko leci
It is high time - to najwyzszy czas
She's managed to beat the clock - zrobic cos przed czasem
better late than never - lepiej pozno niz wcale
at the eleventh hour - w ostatniej chwili
Let’s call it a day - na dzis koniec, wystarczy
They provide round-the-clock support - calodobowy suport
you should have told her - powinienes byl jej powiedziec
If I had known I would have told her - gdybym wiedzial, powiedzialbym jej
tilted - przechylony
multitude of sth - mnogosc czegos
be head over ears in something - byc pochlonietym przez cos(np prace)
fall out of bed - drastyczny spadek (np akcji)
jump ship - porzucenie czegos w trybie natychmiastowym
day in the sun - okres pelny szczescia
bustling - gwar, tloczno
subtle - sbtelne, nieoczywiste
reach out - dotrzec do
The movie was not TO MY liking - film mi sie nie podobal
The movie wasn't TO MY taste. - film nie byl w moim guscie
imperative - absolutely necessary or crucial
meticulously - very carefully and precisely
embedded - contained within something
I didn’t catch that - nie doslyszalem
Can you elaborate on that - czy moglbys to rozwinac?
Drop me a line when you set a date - wyslij mi notke jak ustalisz date(nieformalnie)
when you going to break the news about...? - kiedy podzielisz sie informacja (negatywna)
tu put it in a nutshell - mowiac w skrocie
keep me posted - informuj mnie na biezaco
touch a base with him - skontaktuje sie z nim
I have heard through the grapevine - doszly mnie sluchy…
beat around the bush - owijac w bawelne, mowic niekonkretnie
put someone in the picture - zapoznac kogos z sytuacja
spill the beans - wyjawic sekret
appointment - meeting, spotkanie(formalnie)
sth associates with - kojarzy sie z
keep it up - tak trzymaj
attitude - postawa
willing - chetny
among others - miedzy innymi